29 : 19 : 3
O O O x x x O O O O O O O O O O O x O O O O O O O O O O O
O k x # + # O O O O O O f x O O O x O O O O O O O x x x O
O O O x x x O O O O O O O x x x x x O O O O O x x x w x O
O O O O O O O O O x # x O O O O O O O O O x x x O x x x O
O O O O x x x x x x + x b O x x x x x x x x O x O O O O O
O x x x x O O O O x # x O O x O O O O O O O O x x x O O O
O x O O O O O O O O O O O O x O O $ x $ x $ O O O x x x O
x x O O O O O O O O O O O O x O O x x x x x O O O O O x x
O x O O x $ x O x $ x O O O x O O O x x x O O O x x x x O
O x O O x t x O x t x O O O s O O O O x O O O O x O O O O
O x O O x x x O x x x O O O x O O O O x O O O O x x x x O
O x O O O x O O O x O O O O x O O O O x O O O O O O O x O
O x x x x x x x x x x x x x x O O O O x O O O O O O O x O
O O O O O O O O x O O O O O O O O x x x O O O x x x x x O
O O O O O O O O x O O O O O O O O x O O O O O x O O O x O
O O O O O O O O x O O O O O O O O x O O O O O x O $ x x O
O O O O x x x x x O O O O O O O O x O O O O O x O x x x O
O O O O x O O O O O O O O O O O O x x x x x x x x x x v O
O O O x x x O O O O O O O O O O O x O O O O O O O O O O O