29 : 19 : 2
O x O O x O O O O O O O O O O O O O O O O x O O O O O O O
O x x x x O O O x # x O x x x x O O O O O x O x x v x x O
O O O O O x x x x + x x x O O x O O O O O x O x O O O x O
O O O O x x O O x # x x O O O x O O O O O x O x O O O x O
O x x x x O O O O x O O O O x x x O O O O x x x x x x x O
O x O O O O O O O x O O O O x x x x x O O O O O O O O O O
x x O O x x x x x x x x x x x O O O x O O O O O O O x x x
O x O O x O x x x O O O O O O O O O x O O O O O O O x O O
O x $ O x O x x x O O O O O O O O x x x O O O O O O x O O
O O O O x O O $ O O O O O O s x x x O x O O O O O O x O O
O O x x x O O O O O x x x O O O O x O x x x O O O x x x O
x x x O O O O O O O x O x x x O x # k O O x O O O # + # x
O O x x x x x O O x x O O O x O x + x O O x O O O x x x O
O O O O O O x O x x O O x x x O x # x O x x x O O O x O O
O O O O O O x O x O O O O O O O x O O x x x x x x x x O O
O O f x x O x x x x x x x x x x x O x x x x x O O O O O O
O O O O x O x O O O O x x x O O O O x O O x O O O O $ x O
x x O O x x x O O O O O $ O x x x x x O O x O O O O O x x
O x O O x O O O O O O O O O O O O O O O O x O O O O O O O