35 : 23 : 3
O O O O O O O O O O O O O O O O O x O O O O O O O O O O O O O O O O O
x x x x x x O O O O O O O O O O O x O O O O O O O O O O O x x x x x x
O O O O O x O O O O O O O O O O O x O O O O O O O O O O O x O O O O O
O O O O O x O O O O x x x O O x x x x x O O x x x O O O O x O O O O O
O O O O O x O O O O x O x O O x O x O x O O x O x O O O O x O O O O O
O O O O x x x O O O x O x x x x O x O x x x x O x O O O x x x O O O O
O O O x x x x x O O x O O O O O O x O O O O O O x O O x x x x x O O O
O O O x x v x x O O x O O O O O O x O O O O O O x O O x x k x x O O O
O O O x x x x x x x x O O O O O O x O O O O O O x x x x x x x x O O O
O O O O O O O O O O O O O O O O O x O O O O O O O O O O O O O O O O O
O O O O O O O O O O O O O O O O O x O O O O O O O O O O O O O O O O O
x $ x $ x $ x $ x $ x $ x $ x $ x s x $ x $ x $ x $ x $ x $ x $ x $ x
O O O O O O O O O O O O O O O O O x O O O O O O O O O O O O O O O O O
O O x x O O O O O O O O O O O O O x O x x x x x x x x x x x x x x x O
O O b x x x x x x x O O O O O O O x O x O O O O O O O O O O O O O x O
O O x x O O O O O x O O O O x x x x O x O x x x x x x x x x x x O x O
O O O O O O O O O x O O O O x O O x O x O x O O O O O O O O O x O x O
O O O O O O O O O x x x x x x O O x O x O x x x x x x x x w O x O x O
O O O x x x f O O x O O O O O O O x O x O O O O O O O O O O O x O x O
O O O x O O O O O x O O O O O O O x O x x x x x x x x x x x x x O x O
O O O x O O O O O x O O O O O O O x O O O O O O O O O O O O O O O x O
O O O x x x x x x x O O O O O O O x x x x x x x x x x x x x x x x x O
O O O O O O O O O O O O O O O O O x O O O O O O O O O O O O O O O O O