29 : 19 : 3
O O O O O O O O O O O O O O O O O O O O x O O O O O x O O
O x x x x x x x k O O O O O f x x x x x x x x x O x x x O
O x v x O O O O O O O O O O O O O O O O O O O O O x w x O
O x x x O O O O O x x x x O O O x x x x O O O O O x x x O
O O x O O O O O O x x x x x x x x x x x O O O O O O x O O
x x x O O O x x x x x x x x x x x x x x x x x x x x x x x
O O x x x x x O O x x x x O x O x x x x O O O O O O O O O
O O x O O O O O O O x O O O x O O O x O O O O O O O O O O
O O x O O O O O O O x O O O s O O O x O O O O O O O O O O
O O O O O O O O O O x O O O O O O O x O O O O O O O O O O
O O O O O O O O O O x O O O O O O O x O O O O O O O O O O
O O O O O O O O O x x x O O O O O x # x O O O O O O O O O
O x $ x $ x O O O x O x O O O O O x + x O O x x x x x O O
O x x x x x O O x x x x O O O O O x # x O O x O O O x O O 
O x x x x x O O O O O x O O O O O O x O O x x O O x # x O 
x x x b x x O O O O O x O O O O O O x O O x O O O x + x x 
O x x x x x O O O O O x O O O O O O x x x x O O O x # x O 
O x x x x x x x x x x x O O O O O O O O x O O O O O x O O 
O O O O O O O O O O O O O O O O O O O O x O O O O O x O O 