30 : 20 : 4
O O O O O O O O O O O O O O O O O O O O O O O O O O O O O O
O O O O O O $ $ $ O O O O O O x w x O O O O O O O O O O O O
O O O O O O x x x O O O O O O x x x O O O O O O O O O O O O
O O O O O O O x O O O O O O O O x O O O O O O O O O O O O O
O O x x x x x x x x x x x x x x x x x x x x O O O $ O O O O
O O x O O O O O O O O O O O O O O O O O O x O x x x x x O O
O O x O O x x x x x x x x x x x x x x O O x O x O O O x O O
O O x O O x x x x x x x x x x x x x x O O x O x O O O x O O
O O x O O x x x x x x x x x x x x x x O O x O x x O x x O O
O O x O O x x x x x x x x x x x x x x O O x O x x # x x O O
O v x x x x f x x x x x s x x x x x x x x x x x x + x x k O
O O x O O x x x x x x x x x x x x x x O O x O x x # x x O O
O O x O O x x x x x x x x x x x x x x O O x O x x O x x O O
O O x O O x x x x x x x x x x x x x x O O x O x O O O x O O
O O x O O O O O O O O O O O O O O O O O O x O x O O O x O O
O O x x x x x x x x x x x x x x x x x x x x O x x x x x O O
O O O O O O O x O O O O O O O O x O O O O O O O O $ O O O O
O O O O O O x x x O O O O O O x x x O O O O O O O O O O O O
O O O O O O x w x O O O O O O $ $ $ O O O O O O O O O O O O
O O O O O O O O O O O O O O O O O O O O O O O O O O O O O O